10 10 4
0 0 0 9 9 9 0 0 0 0
0 0 0 9 3 9 0 0 0 0
0 0 0 9 0 9 0 0 0 0
0 0 0 9 2 9 9 9 9 9
9 9 9 9 0 1 2 0 3 9
9 3 2 0 0 0 9 9 9 9
9 9 9 9 2 0 9 0 0 0
0 0 0 9 0 0 9 0 0 0
0 0 0 9 3 0 9 0 0 0
0 0 0 9 9 9 9 0 0 0