10 10 7
0 0 9 9 9 9 9 0 0 0
9 9 9 0 0 0 9 0 0 0
9 3 1 2 0 0 9 0 0 0
9 9 9 0 2 3 9 0 0 0
9 3 9 9 2 0 9 0 0 0
9 0 9 0 0 0 9 0 0 0
9 0 9 0 3 0 9 9 9 9
9 2 0 5 2 2 0 0 3 9
9 0 0 0 3 0 0 0 0 9
9 9 9 9 9 9 9 9 9 9