10 10 2
9 9 9 9 9 9 0 0 0 0
9 0 0 0 0 9 9 9 9 9
9 0 9 9 2 2 0 9 0 9
9 0 9 0 0 9 0 9 0 9
9 0 0 0 0 9 0 9 0 9
9 3 9 0 0 9 0 9 0 9
9 3 0 1 0 9 0 9 0 9
9 0 9 0 0 0 0 0 0 9
9 0 0 0 9 9 9 9 9 9
9 9 9 9 9 0 0 0 0 0