10 10 2
0 0 0 0 0 0 0 0 0 0
0 9 9 9 9 0 0 0 0 0
0 9 0 0 9 9 9 0 0 0
0 9 0 0 1 0 9 0 0 0
0 9 0 0 9 0 9 9 9 0
0 9 9 3 9 2 0 0 9 0
0 9 0 0 2 0 0 0 9 0
0 9 0 0 3 9 9 9 9 0
0 9 9 9 9 9 0 0 0 0
0 0 0 0 0 0 0 0 0 0