10 10 1
0 0 0 0 0 0 9 9 9 0
0 0 0 0 9 9 9 9 9 0
0 0 9 9 9 0 0 0 9 0
0 0 9 3 0 0 0 9 9 0
0 0 9 0 0 0 0 9 0 0
0 9 9 9 0 9 9 9 0 0
0 9 0 0 0 1 0 9 0 0
0 9 0 0 0 2 0 9 0 0
0 9 0 0 9 9 9 9 0 0
0 9 9 9 9 0 0 0 0 0