9 8 2
0 0 0 0 9 9 9 9 0
0 9 9 9 9 0 0 9 9
0 9 0 2 0 0 0 0 9
0 9 0 2 0 9 3 0 9
9 9 0 9 9 9 3 9 9
9 0 0 0 0 0 0 0 9
9 0 0 0 9 0 0 1 9
9 9 9 9 9 9 9 9 9