12 9 2
9 9 9 9 9 9 9 9 9 9 9 0
9 0 0 0 9 0 0 9 0 0 9 0
9 0 1 0 0 0 0 9 0 0 9 0
9 9 9 9 0 0 0 9 0 0 9 0
0 0 9 0 2 9 9 9 9 0 9 0
0 0 9 0 0 0 0 0 0 0 9 9
0 0 9 9 3 9 2 9 0 0 0 9
0 0 0 9 3 0 0 9 0 0 0 9
0 0 0 9 9 9 9 9 9 9 9 9